                              .....                       
                           .'       '.                    
                          .           .                   
                          :           :                   
                          '           '                   
                ,.*====.   '.       .'   .====*.,         
               .-`"/c)}}},    :...:    ,{{{(c\"`-.        
           _.-'-6>   {{{{{'''`     `'''}}}}}   <9-'-._    
          t         |}}}}}}           {{{{{{|         y   
           \__.___.'{{{{{{{           }}}}}}}'.___.__/    
               `[__/}}}}}}}}         {{{{{{{{\__]`        
                {{{.'     `'-._   _.-'`     '.}}}         
                }}/            ```            \{{         
                {{|                           |}}         
                }}|                           |{{         
         .------{{{\    ,               ,    /}}}------.  
        //.--------'    ;               ;   '---------.\\ 
       ((///  _          \             /          _  \\\))
 jgs    (((--' `''-------'`'"'-----'"'`'-------''` '--))) 
                                                          
o< THE 9/11 ATTACK WAS ORCHESTRATED BY PRESIDENT BUSH     
   AND THE ELDERS OF ZION IN ORDER TO FURTHER THEIR       
   PLANS FOR THE NEW WORLD ORDER                          
