             ,______                     
          _./       \_   ZIGGURAT VERTIGO
        /'     -=X=-  \                  
       /        <_>___\___/---_H_        
      Z---|     |-------   --/_O_)       
       __ |__   L___^|^^^^^\--\__/       
      /     \\ __T__ |___                
     / __|__ \\__^  _|   \_              
S-v|-  __^\   _|__| _/ _ __\             
 ----| O  ))==|___ _|==-) ||             
     \ _//            \__//              
