    .....    .....    
  .:' ''::::::'' ':.  
.:'                ':.
:' FULL-BLOWN AIDS  ':
:                    :
:.                  .:
':                  :'
 :                  : 
 :.SOUR        SOUR.: 
 ':                :' 
  :.              .:  
  ':              :'  
   :.SALT    SALT.:   
   ':.          .:'   
    ':.        .:'    
     ':. SWEET.:'     
       ':.  .:'       
JM/tQn   ''''         
