  ______.........--=T=--.........______                         
     .             |:|                                          
:-. //           /""""""-.                                      
': '-._____..--""(""""""()`---.__    I CAN'T FLY THE HELICOPTER 
 /:   _..__   ''  ":""""'[] |""`\\    IN AGHELIA TO SAVE MY LIFE
 ': :'     `-.     _:._     '"""" :                             
  ::          '--=:____:.___....-"                              
                    O"       O" grp                             
